concat()	连接两个或更多的数组，并返回结果。
copyWithin()	从数组的指定位置拷贝元素到数组的另一个指定位置中。
every()	检测数值元素的每个元素是否都符合条件。
fill()	使用一个固定值来填充数组。
filter()	检测数值元素，并返回符合条件所有元素的数组。
find()	返回符合传入测试（函数）条件的数组元素。
findIndex()	返回符合传入测试（函数）条件的数组元素索引。
forEach()	数组每个元素都执行一次回调函数。
indexOf()	搜索数组中的元素，并返回它所在的位置。
join()	把数组的所有元素放入一个字符串。
lastIndexOf()	返回一个指定的字符串值最后出现的位置，在一个字符串中的指定位置从后向前搜索。
map()	通过指定函数处理数组的每个元素，并返回处理后的数组。
pop()	删除数组的最后一个元素并返回删除的元素。
push()	向数组的末尾添加一个或更多元素，并返回新的长度。
reduce()	将数组元素计算为一个值（从左到右）。
reduceRight()	将数组元素计算为一个值（从右到左）。
reverse()	反转数组的元素顺序。
shift()	删除并返回数组的第一个元素。
slice()	选取数组的的一部分，并返回一个新数组。
some()	检测数组元素中是否有元素符合指定条件。
sort()	对数组的元素进行排序。
splice()	从数组中添加或删除元素。
toString()	把数组转换为字符串，并返回结果。
unshift()	向数组的开头添加一个或更多元素，并返回新的长度。
valueOf()	返回数组对象的原始值。

	
	
	
	
	
	
	
	
	
	
	
	
	
	
	
	
	
	
	
	
	
	
	
	
	
	
	
	
	
	
	
	
	
	
	
	
	
	
	
	
	
	
	
	
	